search	n.搜寻 查究v.搜索 搜寻 探求 调查
clip	n.夹子 回形针 子弹夹vt.夹住 剪短 修剪
muslim	n.穆斯林 穆罕默德信徒
me	 pron.我
tell	vt.告诉 说 吩咐 断定 知道vi.讲述 泄密 告发 表明 作证n.<方>讲的事 传闻
racism	n.种族主义 人种偏见 种族歧视
lot	n.签 抽签 一堆 许多 命运 一块地 份额vt.划分vi.抽签 抓阄
everybody	int.每个人 人人
don	n.<西>君 先生(西班牙语冠于男子姓名前) 阁下 (英国剑桥或牛津大学)指导教师vt.穿上
sex	n.性别 男性或女性 性欲 <口>性交 <俚>生殖器 阴茎vt.区别...的性别 引起...的性欲
listener	n.收听者 听众
female	n.女性 女人 雌兽adj.女性的 女子的 妇女的 雌的 柔弱的 (声 色)柔和的
actually	adv.实际上 事实上 竟然 居然 如今
hate	vt.憎恨 恨 不愿 不喜欢n.憎恶 憎恨v.憎恨 讨厌 不愿
weird	adj.怪异的 超自然的 神秘的 不可思议的 超乎事理之外的n.<古><苏格兰>命运 预言 符咒
survey	n.测量 调查 俯瞰 概观 纵览 视察vt.调查(收入 民意等) 测量 勘定 审视 视察 俯瞰 通盘考虑vi.测量土地
someone	 pron.有人 某人
maybe	adv.大概 或许n.疑虑
word	n.字 词 话 消息 诺言 命令vt.为...措辞
racist	n.种族主义者
correlate	vt.使相互关联vi.和...相关
bias	n.偏见 偏爱 斜线vt.使存偏见
york	 约克角[澳大利亚东北部](在约克角半岛) <板球>使击球员出局
united	adj.联合的 团结的 一致的
dissertation	n.(学位)论文 专题 论述 学术演讲
trump	n.王牌 法宝 最后大的手段 喇叭vt.打出王牌赢 胜过vi.出王牌 吹喇叭n.<口>好人
san	Storage Area Networks 存储区域网
read	v.读 阅读 理解 学习adj.有学问的n.读取 vbl.read的过去式和过去分词
racial	adj.人种的 种族的 种族间的
ph	 [域] Philippines  菲律宾; [军] Probability of Hit 命中率; [化](表示氢离子活度的)pH值
percent	n.百分比 百分数
mob	n.(集合词)暴徒 乌合之众 (盗贼等的)一群v.成群暴动 聚众滋扰
honest	adj.诚实的 正直的
frequently	adv.常常 频繁地n.经常地
evan	n.埃文(m.)
baltimore	n.巴尔的摩 美国马里兰州的一城市
anxiety	n.忧虑 焦急 渴望 热望
academic	adj.学院的 理论的
understand	v.懂 了解 听说 推定 以为 省略
truth	n.事实 确实 真理 原理
title	n.头衔 名称 标题 冠军 资格 字幕 权利 扉页vt.赋予头衔 加标题于adj.标题的 用作书名的
suspect	n.嫌疑犯adj.令人怀疑的 不可信的 可疑的v.怀疑 猜想 对...有所觉察
surprising	adj.令人惊讶的
sure	adj.对....有把握 确信某事 稳当的 可靠的adv.的确 当然
super	n.不重要的角色 冗员vt.用冷纱布贴(书背)vi.充当跑龙套的角色adj.上等的 特大的 特级的 十分的 过分的 极好的adv.非常 /n.上标/下标
suicide	n.自杀 自毁 给自己带来伤害或损失的行为
stuff	n.原料 材料 素材资料vt.塞满 填满 填充
stronger	adj.更强壮的
sleep	vi.睡 睡觉n.睡眠
reality	n.真实 事实 本体 逼真
product	n.产品 产物 乘积
primary	adj.第一位的 主要的 初步的 初级的 原来的 根源的
predict	v.预知 预言 预报
pornography	n.色情文学 色情描写
philosophy	n.哲学 哲学体系 达观 冷静
percentage	n.百分数 百分率 百分比
ourselves	 pron.我们自己
okay	n.认可 赞同adj.好的
obviously	adv.明显地
negative	n.否定 负数 底片adj.否定的 消极的 负的 阴性的vt.否定 拒绝(接受)
nature	n.自然 自然界 大自然 自然状态 本性 天性 种类
nation	n.国家 民族
minute	n.分 分钟 片刻 一瞬间 备忘录 笔记vt.记录 摘录 测定时间adj.微小的 详细的 仔细而准确的
million	 num.百万 百万个n.[pl.] 无数
mail	n.邮件 邮政 盔甲vt.邮寄 给...穿盔甲
let	vt.假设 出租 允许 排放 让...进入(或通过) 妨碍vi.出租 (工程等)被承包n.出租屋 障碍
learning	n.知识 学问 学习 学
learn	vi.学习 听到 获悉vt.学习 学会 认识到
incentive	n.动机adj.激励的
god	n.神 上帝 神像 偶像vt.使神化
factor	n.因素 要素 因数 代理人
examples	n.例子
effective	adj.有效的 被实施的 给人深刻印象 有生力量
curiosity	n.好奇心
compare	v.比较 相比 比喻 n.比较
calm	adj.(天气、海洋等)静的 平静的 镇静的 沉着的v.(使)平静 (使)镇定 平息
bowl	n.碗 碗状物 木球v.滚 (板球)投球
advertising	n.广告业 广告adj.广告的
written	vbl.write的过去分词
write	vt.书写 著述 写 写满 写信给vi.写 写字 写信 写作 作曲
window	n.窗 窗口
watch	n.注视 注意 手表 看守 守护 监视 值班人vt.看 注视 照顾 监视 警戒 守护 看守vi.观看 注视 守侯adj.手表的 挂表的
wait	v.(～ for)等待 等候n.等待 等待时间
upon	 prep.在...之上
twitter	n.鸟鸣声 喋喋不休 慌张vi.啭 鸟鸣 摆动vt.嘁嘁喳喳地讲 抖动
twice	adv.两次 两倍
turnout	n.聚集的人群 出席者 产量
tool	n.工具 用具 爪牙 走狗 手段vt.用工具加工 使用设备vi.使用工具
tack	n.大头钉 粗缝 行动方针 食物vt.以大头针钉住 附加vi.抢风航行 作文字形移动
substantially	adv.充分地
substantial	adj.坚固的 实质的 真实的 充实的
subconscious	adj.下意识的
stopped	v.停止 停下来 vbl.停止 停下来
square	n.正方形 广场 平方 直角尺adj.正方形的 四方的 直角的 正直的 公平的 结清的 平方的 彻底的adv.成直角地 正直地 公平地 坚定地v.使成方形 弄平 使直 与...一致 符合 自乘 结算
socially	adv.在社交方面 善于交际地 在社会地位上 在全社会中
sexual	adj.性的 性别的 [生]有性的
sensible	adj.有感觉的 明智的 有判断力的
seek	v.寻找 探索 寻求
secret	n.秘密 秘诀 奥秘adj.秘密的 隐秘的 幽静的、
ruby	n.红宝石
rose	n.蔷薇属 玫瑰 玫瑰红;vbl.rise的过去式;Rose 罗斯(女子名);Remote Operations Service Elements 远程操作服务单元
religion	n.宗教 信仰
relationship	n.关系 关联
reject	n.被拒之人 被弃之物 不合格品 落选者 不及格者vt.拒绝 抵制 否决 呕出 驳回 丢弃
quote	vt.引用 引证 提供 提出 报(价)
provoking	adj.激怒的
predictor	n.预言者 预报器
possibly	adv.可能地 或者
pennsylvania	n.宾夕法尼亚州(美国州名)
oh	int.[表示惊讶、害怕等] 哦 哎哟
nobody	 pron.谁也不 无人 任何人 没有任何人
nasty	adj.污秽的 肮脏的 令人厌恶的 淫秽的 下流的 凶相的 威胁的
mosque	n.清真寺
montage	n.蒙太奇 文学音乐或美术的组合体
mississippi	n.密西西比河(发源于美国中北部湖沼区 南注墨西哥湾 是世界上最大的河流之一) 密西西比州(美国州名)
michigan	n.密歇根州(美国州名)
math	n.数学
martin	n.马丁(男子名)n. 燕子
map	n.地图 图v.绘制地图 [计]由LINK工具生成的一种文本文件 其中包含有被连接的程序的某些信息 例如程序中的组信息和公共符号信息等
luther	n.卢瑟(m.)
listening	n.倾听adj.收听的 注意的
liked	v.喜欢 vbl.喜欢
learned	adj.有学问的 学术上的
knew	vbl.know的过去式
khan	n.可汗(蒙古等族最高统治者的称号) (土耳其和其他东方国家)宿店
islamic	adj.伊斯兰的 伊斯兰教的
insight	n.洞察力 见识
implicit	adj.暗示的 盲从的 含蓄的 固有的 不怀疑的 绝对的
ignore	vt.不理睬 忽视 [律](因证据不足而)驳回诉讼
honesty	n.诚实 正直
heterosexual	adj.异性的 异性爱的n.异性恋的人
heard	 vbl.hear的过去式和过去分词
habit	n.习惯 习性
greg	n.格雷格(Gregory的昵称)(m.)
frequency	n.频率 周率 发生次数
finding	n.发现 发现物 决定 [律]裁决
explicit	adj.外在的 清楚的 直率的 (租金等)直接付款的
evening	n.傍晚 晚间 后期 (联欢性的)晚会
encourage	vt.鼓励 怂恿v.鼓励 鼓励
drop	v.滴下 落下 (使声音等)变弱 (使价格等)下降 使跌倒 使结束 不再讨论 停止与(某人)交往n.落下 下降 滴 滴剂 点滴 微量 下跌
disturbing	adj.烦扰的
desirability	n.愿望 希求
definitely	adv.明确地 干脆地
curious	adj.好奇的 求知的 古怪的 爱挑剔的
consulting	adj.商议的 顾问资格的 咨询的
considered	adj.考虑过的 被尊重的
confidence	n.信心
condition	n.条件 情形 环境 社会地位vt.以...为条件 使达到要求的情况
compulsively	adv.强制地 禁不住地
compulsive	adj.强制的 强迫的 由强迫产生的 禁不住的
clearly	adv.明朗地 明显地 无疑地
chicago	n.芝加哥(美国中西部一大城市)
bless	vt.祝福 保佑 <口>哎呀!我的天哪!
bizarre	adj.奇异的(指态度 容貌 款式等)
argument	n.争论 辩论 论据 论点 ～ (for against) 意见
anxious	adj.观念的 担忧的 渴望的 盼望的
answer	n.答案 回答 答辩 抗辩v.回答说 答复说 符合 反响 响应
anonymous	adj.匿名的
am	prep.是 在n.A.M.上午 午前 [域] Armenia  亚美尼亚 [军] Amplitude Modulation 调幅 (AM) 调幅 (amplitude modulation)
aggregate	n.合计 总计 集合体adj.合计的 集合的 聚合的v.聚集 集合 合计
afterwards	adv.然后 后来地
activity	n.活跃 活动性 行动 行为 [核]放射性
zero	n.零点 零度 num.零
yourself	 pron.你自己
wrote	vbl.write的过去式
writing	n.笔迹 作品 著述
wow	n.叫声 <美俚>哄动一时的人物vi.发出叫声vt.使叫绝
winning	n.胜利 获得 成功 赢得物adj.得胜的 胜利的 动人的
willing	adj.乐意的 自愿的 心甘情愿的 反应迅速的
williams	威廉斯(即Vaughan Williams Ralph)
wife	n.妻子
whereas	 conj.然而 反之 鉴于 尽管 但是
whatnot	n.放古董的架子 不可名状的东西(或人)
weapon	n.武器
wanting	adj.欠缺的 没有的 不够格的 prep.缺 无
voice	n.声音 嗓音 发音能力 意见 发言权 [语法]语态vt.表达 吐露
vocational	adj.职业的
virginia	n.维吉尼亚
violent	adj.猛烈的 激烈的 暴力引起的 强暴的
viewership	n.[总称]电视观众
via	 prep.经 通过 经由
ventricle	n.[解][动]室 脑室 心室
useful	adj.有用的 有益的 有帮手的
upstate	adj.偏僻的 北部的adv.在州的北部n.州的北部
unusually	adv.显著地 异乎寻常地 罕有地
unity	n.团结 联合 统一 一致
unique	adj.唯一的 独特的
uniform	adj.统一的 相同的 一致的 始终如一的 均衡的n.制服vt.使成一样 使穿制服
undesirable	adj.不合需要的 不受欢迎的 令人不快的
unacceptable	adj.无法接受的 不受欢迎的
uh	upper half 上半部分
typical	adj.典型的 象征性的
type	n.类型 典型 模范 [印刷]活字 铅字v.打字 测定(血等)类型
twitch	v.骤然一抽 攫取 抽搐 阵痛 抽动n.急扯 颤动 抽搐 阵痛 痉挛
trust	vt.信任 信赖 盼望 希望 赊卖 热望 切望n.(～ in) 信任 信赖
travel	v.旅行 传播vi.行进 传播n.旅行
toward	 prep.向 对于 为了adj.有希望的 有利的 逼近的 温顺的
tonight	adv.今晚 今夜n.今晚
tone	n.音调 音质 语调 色调 状况 品质 语气 气氛vt.调和 增强 以特殊腔调说 配合 定音调vi.颜色调和
tolerance	n.公差 宽容 忍受 容忍 (食物中残存杀虫剂的)(法定)容许量vt.给(机器部件等)规定公差
tiny	adj.很少的 微小的
thrill	v.发抖
thomas	n.托马斯 [宗]多马(耶稣十二门徒之一)
thirty	 num.三十
thesis	n.论题 论文
thank	vt.感谢 用于表示强制的要求 用将来时
terrorism	n.恐怖主义 恐怖统治 恐怖行动
telescope	n.望远镜v.压缩
tact	n.机智 手法 老练 角觉vt.对(刺激)操作性应答vi.(以言语或声音)操作性应答
syrian	adj.叙利亚的n.叙利亚人
surprised	adj.感到惊讶的
surge	n.巨涌 汹涌 澎湃vi.汹涌 澎湃 振荡 滑脱 放松vt.使汹涌奔腾 急放
supposed	adj.假定的 假像的
subtly	adv.敏锐地 精细地 巧妙地
subject	n.题目 主题 科目 学科 国民 [语法]主语adj.受他国统治的 未独立的 受制于...的 受...影响的 以...为条件的vt.使屈从于... 使隶属
stupid	adj.愚蠢的 麻木的 乏味的
struggling	adj.奋斗的 努力的 苦斗的
struggle	n.竞争 努力 奋斗vi.努力 奋斗 挣扎vt.尽力使得 使劲移动
stretch	v.伸展 伸长n.一段时间 一段路程 伸展
strength	n.力 力量 力气 实力 兵力 浓度
stranger	n.陌生人 门外汉
storm	n.爆发 vt.&vi.猛攻
steve	n.史蒂夫(男子名)
sports	adj.有关运动的
spoken	adj.口头的 口语的 vbl.speak的过去分词
spicy	adj.加香料的 出产香料的 辛辣的 有风味的
speak	v.说话 谈话 说明事实 表示意见 发言 演讲 操(某种语言)
sound	n.声音 语音 噪音 吵闹 海峡 听力范围 探条adj.健全的 可靠的 合理的 有效彻底的 健康的adv.彻底地 充分地vi.发出声音 回响 测深 听起来vt.使发声 宣告 听诊 测...深 试探
somehow	adv.不知何故
societal	adj.社会的
smith	n.铁匠 金属品工匠
slowly	adv.慢慢地 迟缓地
sky	n.天 天空
skill	n.技能  技巧 熟练 巧妙
site	n.地点 场所 遗址vt.定...的地点n.站点
sister	n.姐妹 姐 女会员 修女 妹vt.姐妹般对待
silence	n.静 寂静 沉默 静默vt.使沉默 使安静v.压制
significant	adj.有意义的 重大的 重要的
shown	 vbl.show的过去分词
showing	n.放映
shot	n.开枪 射击 子弹 炮弹
shortly	adv.立刻 不久 简略地 简言之 即刻
shocked	adj.震惊的 震撼的
shock	n.打击 震动 冲突 休克 突击 禾束堆 乱蓬的头发vt.使震动 使休克 使受电击 震惊得vi.震动 吓人adj.蓬乱的 浓密的
shed	vt.流出 发散 散发 脱落 脱皮 摆脱n.分水岭 棚 小屋 工棚 货棚v.把...放入棚内 流下
sexism	n.男性至上主义 蔑视女性
sermon	n.训诫 说教 布道
seriously	adv.认真地 真诚地
send	vt.送 寄 发送 派遣 打发
sellable	adj.=salable
seeming	adj.表面上的n.外观
seated	adj.就座的 固定的
scientist	n.科学家
sample	n.标本 样品 例子vt.取样 采样 抽取...的样品 试验的一部分 尝试
salute	n.(尤指军队等之)举手礼 升降旗致敬 呜礼炮等 敬礼v.行礼致敬 敬礼
sad	adj.忧愁的 悲哀的
ruthlessly	adv.冷酷地 残忍地
river	n.河 江
rice	n.稻 米
rhythm	n.节奏 韵律
revolutionary	adj.革命的
revealed	v.显示 透露 vbl.显示 透露
reveal	vt.展现 显示 揭示 暴露
retrospect	n.回顾
retired	adj.退役的v.退休
reputation	n.名誉 名声
represent	vt.表现 描绘 声称 象征 扮演 回忆 再赠送 再上演vi.提出异议
repeat	n.重复 反复vt.重做 复述 向他人转述 复制 使再现vi.重复 留有味道
removed	adj.离开的 远离...的 与...无关的
relevant	adj.有关的 相应的
relative	n.亲戚 关系词 相关物 亲缘植物adj.有关系的 相对的 比较而言的
related	adj.叙述的 讲述的 有关系的
refinement	n.精致 (言谈 举止等的)文雅 精巧
received	adj.被一般承认的 被认为标准的
reasonable	adj.合理的 有道理的 通情达理的 讲道理的
realize	vt.认识到 了解 实现 实行
reading	n.阅读 知识 读物 表演 对法律条文的解释adj.阅读的
rap	n.叩击 轻拍 轻敲 斥责vt.敲 拍 打 厉声说出 斥责 使着迷vi.敲击 交谈 [军] Rocket Assisted Projectile 火箭助推炮弹
rage	n.愤怒 情绪激动 狂暴 精神错乱vi.大怒 狂吹 风行
radical	adj.根本的 基本的 激进的n.激进分子
racehorse	n.赛马
quite	adv.相当 完全 十分 彻底
quit	vi.离开 辞职 停止vt.离开 放弃 解除 停止
query	n.质问 询问 怀疑 疑问v.询问 表示怀疑
publisher	n.出版者 发行人 /n.出版者/订阅者
psychology	n.心理学 心理状态
proxy	n.代理人
provocative	adj.煽动的n.刺激物
proof	n.证据 试验 考验 [印刷]校样adj.不能透入的 证明用的 防...的 有耐力的vt.检验 校对 使不被穿透
prominent	adj.卓越的 显著的 突出的
profile	n.剖面 侧面 外形 轮廓
professor	n.教授 公开表示信仰的人
professional	n.自由职业者 专业人员 职业运动员 职业艺人adj.专业的 职业的
produce	n.产物 农产品vt.提出 出示 生产 制造 结(果实) 引起 招致 创作
privacy	n.独处而不受干扰 秘密
princeton	n.普林斯顿
pregnant	adj.怀孕的 重要的 富有意义的 孕育的
preferences	n.参数选择
potentially	adv.潜在地
porn	n.<口>(=pornography)色情文学 色情描写
pond	n.池塘v.筑成池塘
please	adj.满足的vt.请v.使喜欢 中...的意 使满足 取悦
plainly	adv.平坦地 明白地
piece	n.块 件 片 篇 张 条 硬币vt.接合 修补 凑合
philosophical	adj.哲学的
phil	n.菲尔(Philip的昵称)(m.)
phase	n.阶段 状态 相 相位v.定相
persuasive	n.说服者 劝诱adj.善说服的
penis	n.阳物 [解]阴茎
paul	n.保罗
parliament	n.国会 议会
paradox	n.似非而是的论点 自相矛盾的话
pair	n.一对 一双
overt	adj.明显的 公然的
overall	adj.全部的 全面的
outlier	n.露宿者 局外人 [地质]外露层
outcome	n.结果 成果
opposed	adj.反对的 敌对的
ohio	n.俄亥俄州(美国州名)
offering	n.提供 奉献物 献礼 祭品
occasion	n.场合 时机 机会
note	n.笔记 短信 (外交)照会 注解 注释 票据 纸币 音符vt.注意 记录 笔记
nightly	adj.每夜的adv.夜夜
murder	n.谋杀 凶杀vt.谋杀 凶杀v.谋杀
moving	 vbl.移动
morning	n.早晨 上午
mix	v.使混和 混淆 混合n.混合
misleading	adj.易误解的 令人误解的
mind	n.头脑 智力 精神 意见 情绪vi.介意 照顾 留心vt.注意 留意 专心于 照看 介意
migraine	n.偏头痛
microsoft	n.美国微软公司
microscope	n.显微镜
met	 vbl.meet的过去式和过去分词
mediocre	adj.普普通通的
measure	n.尺寸 量度器 量度标准 方法 测量 措施vt.测量 测度 估量 分派 权衡 调节vi.量
material	n.材料 原料 物资 素材 布料adj.物质的 肉体的 具体的 重要的 实质性的
mass	n.块 大多数 质量 群众 大量adj.群众的 大规模的 集中的vt.使集合vi.聚集
maniac	adj.发狂的 癫狂的 疯狂的n.[医]燥狂(症)者 疯子 一种高速电子数字计
louisiana	n.路易斯安那 (美国南部的州名)
literally	adv.照字面意义 逐字地
letting	n.出租
legs	n.木头支架
le	Low Explosive 低爆速炸药 Labor Exchange 务实贸易
laboratory	n.实验室
kkk	Ku Klux Klan  三K党
kerry	n.(英国产)黑色的小乳牛
katrina	n.卡特里娜(f.)
journal	n.定期刊物 杂志 航海日记 分类账
jerk	n.性情古怪的人 急推 猛拉 肌肉抽搐 (生理)反射 牛肉干vi.痉挛 急拉 颠簸地行进vt.猛拉
intuition	n.直觉 直觉的知识
internal	adj.内在的 国内的
inside	n.里面 内部 内脏 内情adj.内部的 秘密的 于室内工作的adv.在里面 prep.在...之内
insecure	adj.不可靠的 不安全的
inquiry	n.质询 调查
injured	adj.受伤的 受损害的 受委屈的
incredibly	adv.不能相信地
included	adj.包括的 内藏的
improved	adj.改良的
impression	n.印象 感想 盖印 压痕
impossible	adj.不可能的 不会发生的 难以忍受的
imagination	n.想象 空想 想象的事物 想象力 听觉
ideology	n.意识形态
hurricane	n.飓风 狂风
hundred	n.一百个(人或物)一组 许多 num.百 百个adj.许多的
horrific	adj.令人毛骨悚然的 可怕的 恐怖的
honor	n.尊敬 敬意 荣誉 光荣vt.尊敬 给以荣誉
highly	adv.高地 非常
hi	int.嗨!(引人注意时的喊声 打招呼)
hello	int.喂 哈罗
helicopter	n.直升(飞)机 直升机
hatred	n.憎恨 乱意 仇恨
harvard	 美国哈佛大学
harm	vt.伤害 损害n.伤害 损害
hardly	adv.刚刚 几乎不 仅 严厉的 艰辛的
happening	n.事件 意外发生的事
hal	n.Henry的昵称;Hardware Abstract Layer 硬件抽象层
guy	n.家伙 人 Guy 盖伊(男子名)
guide	n.领路人 导游者 向导 引导者 指南vt.指导 支配 管理 带领 操纵vi.任向导
guard	n.守卫 警戒 护卫队 防护装置vt.保卫 看守 当心vi.防止 警惕 警卫
greatest	adj.最好的 最伟大的
goal	n.目的 目标 守门员 球门 (球赛等的)得分
generally	adv.一般 通常 一般地
gay	adj.欢迎的 <美俚>同性恋的 放荡的 快乐的n.<美俚> 同性恋者 尤指男性同性者
gathering	n.聚集 收款
fringe	n.边缘 须边 刘海adj.边缘的 额外的v.在...上加以缘饰 成为...的边缘
freudian	adj.佛洛伊德的 佛洛伊德学说的n.相信佛洛伊德学说的人
frequent	adj.时常发生的 频繁的
fragile	adj.易碎的 脆的
forget	vt.忘记 忽略vi.忘记 忘形 忘乎所以
flow	n.流程 流动 (河水)泛滥 洋溢vi.流动 涌流 川流不息 飘扬vt.溢过 淹没
floor	n.(房间 走廊等的)地面 地板 基底 (室内的)场地 层 海底 议员席vt.在...上铺(地板) 击倒 (被困难)难倒
flares	n.喇叭裤
fiscal	adj.财政的 国库的 会计的 国库岁入的n.(苏格兰和欧洲某些国家的)检查官 印花税票
fire	n.火 炉火 火灾 失火 闪光 炮火 热情 激情vt.点燃 烧制 使发光 给(炉子等)加燃料 放枪 激动 <口>解雇vi.开枪 射击 着火 烧火 激动
fine	adj.美好的 优良的 杰出的 精美的 杰出的 细 纤细 纯粹n.罚款 罚金 晴天 精细vt.罚款 精炼 澄清vi.变清 变细adv.<口>很好 妙 [常用于构成复合词]细微地 精巧地
favorite	n.特别喜欢的人(或物) 喜欢的事物 亲信 心腹 幸运儿adj.喜爱的 宠爱的 中意的
fairly	adv.公正地 正当的 公平对待某人 公平地 相当地 还算 清楚地
extreme	adj.尽头的 极端的 极度的 偏激的 最后的n.极端 极端的事物
express	adj.急速的 特殊的 明确的n.快车 快递 专使vt.表达 表示adv.乘快车 以快递方式
explain	v.解释 说明
experiment	n.实验 试验vi.进行实验 做试验
existential	adj.有关存在的 [哲]存在主义的 [逻]存在判断的
exist	vi.存在 生存 生活 继续存在
excited	 兴奋的
exceptional	adj.例外的 异常的
exaggeration	n.夸张 夸大之词
evil	adj.邪恶的 带来麻烦的 不幸的 有害的 诽谤的n.邪恶 不幸 罪恶
events	n.事件
equate	vt.使相等 [数]视为平等vi.等同
epithet	n.绰号 称号
episode	n.一段情节 [音]插曲 插话 有趣的事件
entirely	adv.完全地 全然地 一概地
enemy	n.敌人 仇敌 [集合名词]敌军 [喻]大敌adj.敌人的 敌方的
encouragement	n.鼓励 奖励
emphasis	n.强调 重点
email	n.电子信函
effectiveness	n.效力
edit	vt.编辑 校订 剪辑n.编辑工作
drunk	adj.喝醉了的 vbl.drink 的过去分词
drill	n.钻孔机 钻子 播种机 军事训练 操练 (反复)练习 条播机v.训练 钻孔 条播
drawing	n.图画 制图 素描术
doubled	v.两倍 快步走 加倍努力 vbl.两倍 快步走 加倍努力
divide	v.分 划分 分开 隔开
disturbingly	adv.令人不安地 动摇地
dirty	adj.肮脏的 卑鄙的 下流的 暴风雨的 恶劣的(天气)vt.弄脏vi.变脏
dignity	n.尊严 高贵
difficulty	n.困难 难点
differently	adv.不同地
difference	n.差异 差别 分歧 争论 [数]差额 差分adj.[数]微分的 [机]差动的
die	vi.死亡 消逝 平息 渴望 漠然 熄灭vt.死n.骰子 钢型 硬模 冲模
destroy	vt.破坏 毁坏 消灭v.消灭 摧毁
desire	vt.想望 期望 希望 请求(官方丈礼)n.愿望 心愿 要求v.要求
desirable	adj.值得要的 合意的 令人想要的 悦人心意的
descriptor	 [计] 描述符
description	n.描写 记述 形容 种类 描述
depression	n.沮丧 消沉 低气压 低压
depressed	adj.沮丧的 降低的
degree	n.度数 度 程度 [律](罪行的)轻重 学位 地位 身份 [数]次数
definition	n.定义 解说 精确度 (轮廓影像等的)清晰度
deciding	 vbl.决定
decide	v.决定 判决
deception	n.欺骗 诡计
de	 [域] Germany  德国; Direct Etching 表面刻蚀
database	n.[计] 数据库 资料库
daily	adj.每日的 日常的adv.每日 日常地 天天n.日报 <美口>朝来夜去的女佣
curtail	vt.缩减 减少(经费等) 剥夺(某人的)特权(或官衔等) 简略
crazy	adj.疯狂的 狂热的 (指建筑等)不安全的
covert	adj.隐蔽的 偷偷摸摸的 [律]在丈夫保护下的n.掩蔽处 隐藏处
couple	n.(一)对 (一)双 夫妇vt.连合 连接 结合vi.结合 结婚
countryside	n.乡下地方 乡下居民
correlated	adj.有相互关系的
correct	adj.正确的 恰当的 端正的vt.改正 纠正 告诫 惩戒
copy	n.副本 拷贝 摹仿 一册v.复印 复制 拷贝 抄袭
convinced	adj.确信的 深信的
conversation	n.会话 交谈
considering	 vbl.考虑 顾及 认为 prep.鉴于 考虑到 顾及
consciously	adv.有意识地 自觉地
confirmation	n.证实 确认 批准
confessional	adj.自白的 忏悔的n.(教堂中神甫听取忏悔的)忏悔室
condom	n.避孕套
comparison	n.比较 对照 比喻 比较关系
community	n.公社 团体 社会 (政治)共同体 共有 一致 共同体 (生物)群落
commons	n.平民 下院 公共用 (前面与the连用)英国国会下院
colonoscopy	n.[医]结肠镜检查
colleague	n.同事 同僚
cnn	美国有线新闻网络 以提供即时电视新闻报导而闻名
clue	n.线索
climate	n.气候 风土 思潮
classic	n.[pl.] 杰作 名著adj.第一流的
citizen	n.市民 公民
cheat	n.欺骗 骗子v.欺骗 骗取
charismatic	adj.神赐能力的 超凡魅力的
charisma	n.超凡魅力 感召力 教皇般的指导力
chaos	n.混乱 混沌(宇宙未形成前的情形)
certain	adj.确定的 某一个 无疑的 必然的 可靠的 pron.某几个 某些
ceo	Chief Executive Officer 执行总裁
carry	n.进位 射程 运载vt.携带 运送 支持 支撑 传送 意味vi.被携带 能达到
carbon	n.[化]碳(元素符号C) (一张)复写纸
capture	n.捕获 战利品vt.俘获 捕获 夺取
calculate	v.计算 考虑 计划 打算v.<美>以为 认为
bunch	n.串 束v.捆成一束
brinkman	n.边缘主义者 实行边缘政策者
brian	n.布赖恩(亦作Bryan)(m.)
breathing	n.呼吸 瞬间 微风adj.呼吸的 逼真的 短暂的休息
break	n.休息 暂停 破裂 突变v.打破 违犯 折断 削弱 超过 突变
bound	n.跃进 跳 范围 限度adj.正要启程的 开往...去的 被束缚的 装订的v.跳跃 限制
bottom	n.底 底部 尽头 末端adj.底部的vt.装底 查明真相 测量深浅vi.到达底部 建立基础
bonded	adj.抵押的 以债券作保证的 有担保的 存入保税仓库的
biased	adj.(统计试验中)结果偏倚的 [数]有偏的
berlin	n.(=Berlin wool)细毛线n.柏林(德国城市)
berkeley	 伯克利[美国加利福尼亚州西部城市]
belief	n.信任 信心 信仰
behavior	n.举止 行为
bed	n.床 基础 路基 河底 海底 一堆 一层vt.安置 嵌入 使睡 栽种vi.上床 分层  教育学士 BEd(Bachelor of Education)
beautiful	adj.美丽的 很好的
bbc	n.英国广播公司
basketball	n.篮球 篮球运动
basically	adv.基本上 主要地
balance	n.秤 天平 平衡 [商] 收支差额 结余 余额v.平衡 称 权衡 对比 结算n.资产平稳表
background	n.背景 后台 不重要或不引人注目的地方或位置
baba	n.兰姆糕 <印>孩子 婴儿
awkward	adj.难使用的 笨拙的
awareness	n.知道 晓得
author	n.作家 创造者
asking	n.问 寻问 请求 vbl.问 要求
army	n.陆军 军队 大群 大军
appeal	n.请求 呼吁 上诉 吸引力 要求;vi.求助 诉请 要求;vt.控诉
anyone	 pron.任何一个
anybody	 pron.任何人 重要人物
anonymously	adv.不具名地 化名地
anonymity	n.匿名 作者不明(或不详)
animus	n.敌意 意图
animosity	n.仇恨 憎恶
animal	n.动物
angst	n.焦虑 担心
amount	n.数量vi.(to) 总计 等于
almighty	adj.全能的
alabama	n.阿拉巴马州(美国的一个州)
airport	n.<主美>小型民用机场 私人飞机降落场
agree	vi.同意 赞成...的意见 与...一致 承认 适合vt.同意
aggressive	adj.好斗的 敢作敢为的 有闯劲的 侵略性的
afterward	adv.然后 后来
adams	n.亚当斯
actual	adj.实际的 真实的 现行的 目前的
accurate	adj.正确的 精确的
academia	n.学术界 学术环境
abuse	n.滥用 虐待 辱骂 陋习 弊端v.滥用 虐待 辱骂
absurdity	n.荒谬 谬论
